#######
#   # #
#   # #
#   # #
# #   #
# #   #
# #   #
# #   #
# # # #
# #####
#S  #E#
#######