#######
#   # #
#   # #
#   # #
# #   #
# #   #
# #   #
# #   #
# # # #
# ### #
#S  #E#
#######